6 6 6 6 6 6 6 6 6 6 6 6 6 6 6 6 6 6 6 6 6 6 6 6 6 6 6 6 6 6 6 6 6 6 6 6 6
5 0 9 9 9 9 9 0 0 0 0 0 0 0 0 0 0 0 0 0 0 0 0 0 0 0 0 0 0 0 0 0 2 2 2 2 5
5 0 9 0 0 0 9 0 0 0 0 0 0 0 0 0 0 0 0 0 0 0 0 0 0 0 0 0 0 0 0 0 2 0 0 0 5
5 0 9 0 2 9 9 0 0 0 0 0 0 0 0 0 0 0 0 0 0 0 0 0 0 0 0 0 2 2 2 2 2 0 0 0 5
5 0 0 0 2 0 0 0 0 0 0 0 0 0 0 0 0 0 0 0 0 0 0 0 0 0 0 2 2 0 0 0 0 0 0 0 5
5 0 0 0 2 0 0 0 2 0 0 0 0 0 0 0 0 0 0 0 0 0 0 0 0 2 2 2 0 0 0 0 0 0 0 0 5
5 0 0 0 2 0 0 0 2 0 2 2 2 0 0 0 0 0 0 0 0 0 0 0 2 2 0 0 0 0 0 0 0 0 0 0 5
5 0 0 0 2 2 2 2 2 2 2 0 2 2 2 2 2 2 2 0 0 0 0 0 2 0 0 5 0 0 0 0 0 0 0 0 5
5 0 0 0 0 0 2 0 0 0 0 0 0 0 0 2 0 0 2 0 0 0 0 0 2 0 0 5 5 0 0 0 0 0 0 0 5
5 0 0 0 0 2 2 0 0 0 0 0 0 0 0 2 0 2 2 2 2 2 2 2 2 0 0 0 5 0 0 0 0 0 0 0 5
5 0 0 0 0 2 0 0 0 0 0 0 0 0 0 2 2 2 2 0 0 0 0 2 0 0 0 0 0 0 0 0 0 0 0 0 5
5 0 0 0 0 0 0 0 0 0 0 5 0 0 0 0 0 0 0 1 1 0 0 2 2 2 0 0 0 0 0 0 0 0 0 0 5
5 0 0 0 0 0 0 0 0 0 0 5 0 0 0 0 0 0 0 1 0 0 0 0 0 2 2 2 0 0 0 0 0 0 0 0 5
5 0 0 0 0 0 0 0 0 0 5 0 0 0 0 0 0 1 1 1 0 0 0 0 0 0 0 2 0 0 0 0 0 0 0 0 5
5 0 0 0 0 0 0 0 5 5 5 5 0 0 0 0 0 1 0 0 0 6 6 6 6 6 0 2 2 2 0 0 0 0 0 0 5
5 0 0 0 0 0 0 5 0 0 5 0 0 0 0 0 0 1 0 0 0 6 8 8 8 6 0 0 0 2 2 0 0 0 0 0 5
5 0 0 0 0 0 0 0 5 0 0 1 0 2 2 2 2 2 0 5 5 6 8 8 8 6 0 0 0 0 0 0 0 0 0 0 5
5 0 0 0 0 0 0 0 0 0 0 2 0 2 0 0 0 0 0 0 0 6 8 6 6 6 0 0 0 0 5 0 0 0 0 0 5
5 0 0 0 0 0 0 0 0 0 0 0 2 2 0 0 0 0 0 0 0 0 0 0 0 0 0 0 0 0 5 5 0 0 0 0 5
5 0 0 0 0 0 0 0 0 0 0 0 0 0 0 0 0 0 0 0 0 0 0 0 0 0 0 0 0 0 0 5 0 0 0 0 5
5 0 0 0 0 0 0 0 0 0 0 0 0 0 0 0 0 0 0 0 0 0 0 0 0 0 0 0 0 5 5 0 0 0 0 0 5
6 6 6 6 6 6 6 6 6 6 6 6 6 6 6 6 6 6 6 6 6 6 6 6 6 6 6 6 6 6 6 6 6 6 6 6 6
